20 20
####################
#%h%%..hd..ppd...A$#
#%G%.G%ddsdddd.A.As#
#%.%.%dddsdddd.A..s#
#d...*.....%%%.ZXXX#
#QWE%%.%%%.%d...ddd#
#AaD%%G%p%.......Gh#
#A.D...%s%...*..%%%#
#ZGC.%%%.........dd#
#..%..%...dd..ddddd#
#.%%%.%...dddddQWEd#
#.%...%.*...sG.!cDd#
#...%%%....ddddZXCd#
#%%%%%..dd....ddddd#
#...%dd..dddd....dd#
#.QMEddd..d........#
#.AVDdddd..Gd%.@.%.#
#sZXCddddd.dd%%U%%.#
#..*.......dd%%%%%^#
####################